1111111111111
1000000000001
10010000000C1
1P00011111001
100011E000001
1000000000001
1111111111111