1111111111111
1CC10000000C1
100C011011001
1P0011E00C001
1111111111111