111111111
1C001C0E1
10C010001
10P0000C1
111111111